 ####
 #  ###
##    ####
#  * *   #
# $#*#*  #
## * *   #
 #  @ * ##
 ###  ###
   ####