14
 #####
 #   #
##$# ###
#  .$@ #
# #  # #
# #..$ #
#   ####
#####