12
    ####
#####  #
#   $  #
#  .#  #
## ## ##
#      #
# @#   #
#  #####
####