17
 #####
 #   ##
## #$ ##
# $    #
#. .#  #
### @ ##
  # # #
  #   #
  #####