13
 #####
 #   #
##$# ###
#   $@ #
# #  # #
# #. . #
#   ####
#####